111111111111111111111111111111
10000CCC00000CCC0000000K000001
100CCCCCCC0CCCCCCC000111111111
100CCCCCCC0CCCCCCC000000000001
100CCCCCCCCCCCCCCCC00111111111
10CCCCKCCCCCCCCCCCC00000000K01
10CCCCCCCCCCCCCCCCC01111111111
100CKCCCCCPCCCCCCCC00000000001
100CCCCCCCCCCCCCC0001111111111
1000CCCCCCCCCCCC00000000000001
10000CCCCCCCKCCC00000000000001
10K000CCCCCCCCC00000000K000001
1000000CKCCCCC000000000E000001
10000000CCCCC00000000000000001
111111111111111111111111111111
