111111111111111111111111111111
100000000000000000001001010101
111111111100000000001001010101
100000000000000000001001010101
111111111100000000001001010101
100000000000000000001001010101
111111111100000000001001010101
100000000000000000001001010101
111111111100000000001000000001
100000000000000000K01000000001
111111111100000000001000000001
1000000000000000C1C01000000001
10000000000000P000000E11000001
1000000000000000C0000100100C01
111111111111111111111111111111
